1111101
1000001
1000001
100N001
1111111